222222222222222222222222222 
22222222222222222222222222#     												  	
#22222222222222222222E2222#														
#######XXX22XXX############													
#222222222222222###########
#222222222222222###########
#########XXXXX22###########
#2222222222222222222222222#
#2222222222222222222222222#
########################22#
#2222222222222222222222222#
#2222222222222222222222222#
#22XXXX####################
#22XXXX####################
#2222222222222222222222222#
#2222222222222222222222222#
######################2222#
#####222222222222222222222#
#####222222222222222222z22#
###########################

