222222222222222222222222222 
222222222222222222222222222     												  	
#2222222222222222222222222#															
#######XXX22XXX#XXX2222XXX#													
#222222222222222###XX22####
#222222222222222#####22####
#########XXXXX22#####22####
#2222222222222222222222222#
#2222222222222222222222222#
########################22#
#222222222222222222222XX22#
#2222222222222222222222222#
#2222XX#############222222#
#2222XX####################
###22222222222222222222222#
###22222222222222222222222#
#########22###########2222#
#####222222222222222222222#
#####2222222222z2222222222#
###########################