N22222222222222222222222222 
222222222222222222222222222     												  	
2222222#22222222222222#####														
2222222#22222222222222#####													
2222M22#22222222222222#####
########22222222222222#####
2222222222222222222222#####
222222222222222222222222222
222222222222222222222222222
222222222222222222222222222
222222222222222222222222222
222222222222222222222222222
222222222222222222222222222
222222222222222222222222222
222222222222222222222222222
222222222222222222222222222
222222222222222222222222222
2222222222222EB222222222222
22222222222222222222222z222
222222222222222222222222222

